X...................
####.A...A..A.A.....
...#############....
....G.--............
...--...............
...........A.....##.
...--....####.......
...............P....
...--..........##...
...G.....#.....G....
.......#.......--...
............#...G...
.........#.....--...
.1....P......A......
####################
